11111111111111111111
10010000000000000001
10111101110111000101
10100101010101001001
10000001010101001001
10010101000101000001
10110001111101011101
10000000000001110101
1PC0E001001000000001
11111111111111111111
