1111111111111111111111111111111111111111111111111111111111111111111111111111
10000000000C000000000000000C00000000000000000000C000000000000000000000000111
1000000000000000000000000C0000000000000000C000000000000000000000000000000001
100111111100011111110000C0000000000000000C0000000000000000111111101111111001
1001111111000111110C0000000000000000000C000000000000000110111111101111111001
100110P111000000011C000000000000000010000011101100111000000C0000000000000001
10000001110001111111000C000000000000000000C000000000000000111111101100111001
1000000111000111110000C00C00000000000000000000000000000110111111100000111001
100000011100000000000C00000C000000000000000000000000001110000011100000111001
100000011100011110000C00000C000000000000000000000000001110111111100000111001
100001111111011110000C000000000C0000000000000000000000111011111110000E111001
100000000000000000000C0000000000C0000000000000000000000000000000000000000001
10000000000000000000C000000000C000000000000000000000000000000000000000000001
1000001000000010010000C0000000C000000000000000000000000010100101001010010101
1101001001010001000000C000000000C0000000000000000000000000000100100000000001
100000000000000000000000000C000000C00000000000000000000000000000000000000001
100000100000001001010100C000000000000000010000C00000000000000001001010010101
110100100101000100000000100C0000000000000000000C0000000000000000100000000001
1101001001010001000000000C0000000000000000C000000000000000000100100000000001
1000001000000010010000C0000C000000000000000000000000000010100101001010010101
1101001001010001000000C0000C000000000000000000000000000000000100100000000001
100000000000000000000000000C0000000000000000C0000000000000000000000000000001
100000100000001001010100100C000000000000000000C00000000000000001001010010101
110100100101000100000000100C0000000000000000000C0000000000000000100000000001
1101001001010001000000000C0C000000000000000000000000000000000100100000000001
10000000000000000000000000CC000000000000000000000000000000000000000000000001
1000001000000010010000C000C0000000000000000000000000000010100101001010010101
1101001001010001000000C00000C00000000000000000000000000000000100100000000001
100000000000000000000000000CC00000000000000000000000000000000000000000000001
10000010000000100101010010000C00C0000000000000000000000000000001001010010101
110100100101000100000000100000C0C0000000000000000000000000000000100000000001
1101001001010001000000000C0000000C000000000000000000000000000100100000000001
1000001000000010010000C0000000000000000101001C000000000000000001001010010101
1101001001010001000000C000000000000000000000C0000000000000000100100000000001
100000000000000000000000000C0000000000000000C0000000000000000000000000000001
10000010000000100101010010000C00000000000000C0000000000000000001001010010101
110100100101000100000000100000C0000000000000C0000000000000000000100000000001
1101001001010001000000000C0000000000000000001C000000000000000000100000000001
10000000000000000000000000C00000000000000000000C0000000000000000000000000001
100000100000001001010000C0000000000000000100101C0000000000000000001010010101
11010010010100010000000C000000000000000000001001C000000000000000000000000001
1111111111111111111111111111111111111111111111111111111111111111111111111111
