1111111111111111111111
10CCCCCCCC1P0000000011
1C11111110111111100011
1100000000000000000001
1100000000000000011111
1100000000000000000E11
1111111111111111111111