111111111111111111111
100000000000000000011
111101011111011110011
1P10000000C1111000001
101010000000000000001
100000000000000000001
100000000100000000001
1000C0000000000000001
100001100000000010001
100000000000000000001
100100000000000000001
100011111000000000001
100000E11111100000001
100000000000000000011
111111111111111111111