111111111111111
101010101010101
110C01010101P11
100000000000001
100000000000001
111111101111111
1E0000001111111
111111111111111