1111111111111111111111111111111111111111111111111111111111111111111111111111111111111111111111111111
1000000000000000000000000000000000000000000000000000000000000000000000000000000000000000000000000011
1011111111111100011111111111111111111111111111111111111111111111111111111111111111111111111111100011
1000000000000000000000000000000000000000000000000000000000000000000000000000000000000000000000010011
1000111111111111111111111111111111111111111111111111111111111111111111111111111111111111111100010011
10000000000000000000000000000000000000000000000P0000000000000000000000000000000000000000000000010011
1000111111111111111111111111111111111111111111111111111111111111111111111111111111111111111100010011
1000000000C00000000000000000000000000000000000000000000000000000000000000000000000000000000000100111
1011111111111111111111111111111111111111111111111111111111111111111111111111111111111111111100010011
10000000000000000000E0000000000000000000000000000000000000000000000000000000000000000000000000010011
1000111111111111111111111111111111111111111111111111111111111111111111111111111111111111111100010011
1000000000000000000000000000000000000000000000000000000000000000000000000000000000000000000000010011
1000111111111111111111111111111111111111111111111111111111111111111111111111111111111111111100010011
1000000000000000000000000000000000000000000000000000000000000000000000000000000000000000000000010011
1000111111111111111111111111111111111111111111111111111111111111111111111111111111111111111100010011
1111111111111111111111111111111111111111111111111111111111111111111111111111111111111111111111111111