1111111111111111111111111111111111111111111111111111111111111111111111111111111111111111111111111111
1000000000P00000000000000000000000000000000000000C000000000C0000000000000000000000000000000000000001
1000000C000000000000000000000000000000000000000000000000000000000000000CC000000000000000000000000001
100000000000000000000000000000000000000000000000000000000000000C000000000000000000000000000000000001
10000C000000000000000000000000000000000000000000000000000000000000000000000000C000000000000000000001
1000000000000000000000000000000000000000000000000000000000000000000000C00000000000000000000000000001
100000000000000000000000000000000000C00000000000000000000000000000000000000C000000000000000000000001
10000000C000000000000000000000000C000000000000000000000000000000000000000000000000000000000000C00C01
10000000C000000000000C000000000000000000000000000000000000000000000000000000000000000000000C00000001
100000000000000000000000C00000C0000000000000000000000000000000000000000000000C0000000000000C00000001
1C0000000000000C00000000000000000000000000000000000000000000000000000000000000000000000000C000000C01
10000000000000000000000000000000000000C0000000000C0000000000000000C000000C000000C0000000000000000001
10000000000000C0000000000000000000000000000000000000000000000000C0000000000000000000000C000000000001
1000000000000C0000000000000000C000000000000000000C000000000000000000000C00000000C000000C000000000001
100000000000000C00C0000000000000000000000000000000000000000000000C0000000000000000000C00000000000001
1000000000000000000000000000000000000000000000000000000000000000000000000000000000C00000C00000000001
1000000000000000000000000000000000000000000000000000C00000C0000000000C000000000000000000000000000001
100000000C000000000000000000C0000000000000000000000C0000C0000000000000000000000000000000000000000001
1000000000000000000000000000000000000000000000000000000000000000000000000000000000000000000000000001
100000000000000000000000000000000000000000000000C000000000000000000000000000000000000000000000000001
100000000000000C0000000000000000000000000000000000000000000000000000000000000000000000000C000000C001
1C000000000000000000000000000000000000000000000000000000C000000000000000000000000C0000000000000000C1
10000000C00000000000000000000000000000000000000000000000000000000000000C000000C000000000000000000001
10000000000000000000000000000000000000000000000000000000000000000C0000000000000000000000000000000001
1000000000000000000000000000000000000000000000000000000000000000000000000000000000000000000000000001
10000000000000000000C0000C000000000000000000000000000C00000000000000000000C0000000000000000000000001
1000000000000000000000000000C0000000000000000000000000000000000000000000C00000C000000000000000000001
1000000000000000000000000000000000000000000000C0000000000000000000000000000000C000000000000000000001
100000000CC0C0000000C00000000000000000C0000000000000000000000000000000000000000000000000000000000001
10000000000000000000000000000000C00000000000000C0000000000000000000000000000C00000C00000000000000001
100C00C0C0000000000000000000000000000000000000000000000000000000000000000000000000000000000000000001
10000000C000C000000000000000000000000000C0000000000000000000000000000000000000000000000C000000000001
100000000C0000C000C00000000000000000000000000000000000000000C00000000C000C00000000000000000000000001
10000000000000000000000000000000000000000000000000000000000000000000C0000000000000000000000000000001
10000000000000000CCC0000000C000C000000000C00000000C00000000000000C000000000000C00000000000000C00C001
1000000000000000000000000000000000000000000000000C00C000000000000000000000000000000000C0C00000000001
1000C0000000000000000000C000000C000000000000C0000C00000000000000000000000000C00000000000000000000001
10000000000000000000000000000000000C000000000000C0000000000C0000000000000000000000000000000000000001
100000000000000C0000000000000000000000000000000000000000000000000000000C0000000000000000000000000001
10C0000000000000000000000000000000000000000000000000000000000000000000C0000000000C0000C0000000000001
100000C0000000000000000000000000000000000000000000000000000000000000000000000000000000000000C0000001
10000C000000000000000000000C0000000000000000000000000000000C0000000000000C0000000000000000000000C001
1C00000000000000000000000000000000000000000000000000000000000000000000000000000000000000C00000000001
1C000C0000000000000000000000000000000000000000000000000000000000000000000000000000000000000000000001
100000000C000000000000000000E000000000000000000000000000000000000000000000000000000C00000000C0C000C1
10000000000000000C0000000000000000000000000000C00000000000000000000000000000000000000000000000000001
1000000000000000000000000000000000000000000000000000000000000000000000000000000000000000000000000001
100000000000000C0000000000000000000000000000000000000000000C000000000000000000000C000000000000000001
10000000000000000000CC000000000000000000000000000000C00000000000000000000000000000000000000000000001
1111111111111111111111111111111111111111111111111111111111111111111111111111111111111111111111111111