1111111111111111111111111111111111111
1P00000000000000000000000000000000EC1
1000011111111111111111111111111000011
1000011000000000000000000000011000001
1000011000111111111111111000011000001
1000011000111000000000111000011000001
1000011000111000000000111000011000001
1000011000111000000000111000011000001
1000011000111111111111111000011000001
1000011000000000000000000000011000001
1000011111111111111111111111111000001
100000000000000C000C000000000000C0011
1111111111111111111111111111111111111