1111111111
10P1111111
10CE111111
1111111111