11111111111111111111
10E100000000000000C1
10111101110111000101
10100101C101C1001001
10000C01010101001001
10010101000101000001
10110001111101C11101
1110000000000111C101
1P001001001000000001
11111111111111111111