11111111111111111111
1XX000000XXXXXXX0001
1XX00000000000000001
1X111001110111011101
1X101000010001010101
1X001001110111000101
10001000E10001000101
10011101110111000101
10000000000000000001
10000000000000P00001
10000000000001110001
10111111100100100101
10100X00101010001011
10101110110001010001
10101010100000000001
10101010101010101011
10000010000000000001
1C0C0C1C0C0C0C0C0C01
1X0000100000000000X1
11111111111111111111