11111111111111111111
10000000000000000001
10000000000000000001
10111001110111011101
10101000010001010101
10001001110111000101
10001000E10001000101
10011101110111000101
10000000000000000001
10000000000000P00001
10000000000001110001
10111111100100100101
10100000101010001011
10101110110001010001
10101010100000000001
10101010101010101011
1X0X0X1X0X0X0X0X0X01
1C0C0C1C0C0C0C0C0C01
10000010000000000001
11111111111111111111