1111111111
1110XX0111
11C0110C11
1000000001
1010110101
101X11X101
1X000000X1
1100110011
111E00P111
1111111111